##############################
#A     #     #   #           #
##### ### ### # ### ####### ##
#     #   #   # #   #       #
# ### ##### ##### # ####### #
#   #       #     #   #     #
### ### ### ### ##### # #####
# #     #   # #   #   #     #
# ##### ### # ##### ### #####
# #     #   #   #   #     # #
# # ####### ### ### ##### # #
# # #     #   #   #   #   # #
### ### # ### ### ### # ### #
# #   # #   #   #     #   # #
# ### ##### # ##### ####### #
#   # #     #   #     #   # #
##### # ### ##### ##### # # #
#   #   # #     #     # # # #
# ####### # ### # ### # ### #
#       # #   #   #   #     #
##### ##### ##### # ##### ###
#   #   # #     # #     #   #
### ### # ### ### ##### ### #
#     # #   # #   #     #   #
# ##### ### # # # # ### ### #
#     #   # #   # #     #   #
# ### ### ### ### ####### ###
#   #   #   #       #     # #
### ### ### ### ####### # ###
#           #           #B  #
##############################
