#########################
#A      #               #
##### # ### # # ####### #
#   # # #   # #       # #
# ### ### ### ####### # #
# #       #   #   #   # #
# ####### # ##### ##### #
#   #   #   #     #     #
### # # ### ### ### ##### 
#   # #     #   #     # #
# ####### ##### ####### #
#   #     #   #       # #
### # ### # ### ####### #
#   # #   #   # #       #
# ### # ### ### # ##### #
#     #   #   # # #     #
##### ##### ### # # ### #
#         #     # #   # #
########### ##### ##### #
#     #   #     #       #
# ### # # # ####### #####
# #   # # #         #   #
# # ### ##### ##### # # #
#       #     #       #B#
#########################
