#######################
# A   #               #
### # ### ### ####### #
#   #   #   #     #   #
# ### ### ####### # ###
# # #     #     # # # #
# # ##### # ### # # # #
# #     # #   #   # # #
# ### # ##### ##### # #
# #   # #     #     # #
# # ### # ####### ### #
# # #   #       # #   #
# # ### ####### # # ###
# #   #       # # #   #
# ### ####### # # ### #
#   #       #   # #   #
### # ##### ##### # ###
#   #   #       #   # #
# ##### ##### ####### #
#     #     #     B   #
#######################
