####################################################################################################
#A #        #               #        #                 #    #        #          #                # #
#  #######  ########## ###### ###### ######## ######## # #### ####### ######### ######### ####### # #
#  #       #    #      #     #      #        #        #      #       #         #         #         # #
#  ####### #### # #### #### ###### ####### #### ######## ########### ########### ######### ######### #
#        #      #    # #     #        #    #  #       #            # #         #        # #          #
# ########### ####### # ####### ####### ##### ##### ### ########## # ######### # ######## # ######### #
#          # #       #       #        # #     #     #        #    #         # # #        # #         #
# ########## ####### ###### ######### # ####### ### ######## # ### ######### # ### ####### ####### ###
#          #       #      #         # #         #   #        # #           # #     #       #        # #
# ########## ##### ###### # ######## ########## #### ####### # ########### # ####### ####### ####### # #
#         #     #       # #        #          #     #     # # #         # # #       #       #     # # #
######### ####### ##### # ######### ######### ########### # ### ####### # # # ####### ####### ### # # #
#       #             # # #       # #       #           # #   #       # # #   #         #       # # # #
# ##### ####### ##### # ### ### ### ####### ########### ####### ##### ### ##### ####### # ##### # # # #
# #          #       #         #     #       #       #         #     #     #       #   # #     # #   #
# # ######### ######### ##### # ####### ########### ### ########### ### ####### ##### ### ####### #####
# # #       #         # #   # # #     # #         #   #   #       #   # #     #     #     #     # #   #
# # ##### ### ####### # ### # ### ### # # ##### ##### ### ####### ### # # ### ####### ##### ### # # # #
# #     #   #       # #   # #   #   #   #     # #     #   #     #     #   #   #         #   # # # # # #
# ### ####### ### ### ##### # ####### ##### ### # ####### ### ### ####### ##### ####### ### ### # # # #
#   #     #   #   # #       #       #     #   # #       #   # # #       #     # #     #     #   # # # #
##### ### ##### # # ####### ##### # # ### # ### ####### # ### # # ####### ### ### ### ### ####### # # #
#     #     #   # #   #   #   #   #   #   #     #     # # #   #     #     # # #   # # #   #       # # #
# ####### # # ##### # # ### # # # ####### ##### # ### # # # ##### ### ### # ### ##### ### # ##### ### #
#       # # #     # # #   # # # # #     #     # #   # # # # #     # #   # #     #       # #   # #     #
####### # # ### # # # ##### # # ##### ##### ##### ### # # # # ##### ### # # ### ######### ### # #######
#     # # #   # # # #       # #     #   #     #       # #   # #     #   #   # #         # #   #       #
# ### # ### ### ### ##### ### ####### ##### ### ### ####### # # ### ##### ### ####### ### ### #########
# #   #   #     #       #   #     #       # # #   #     #   #   #   #     #     #   #     #   #       #
# # ##### ##### ##### ####### ##### ##### # # ### ### ### ######### # ### ####### # ### ##### ### ### #
# #     #       #   #         #     #     #     # # # #       #   # # #   #       #     #   #     # # #
### ### ######### # ####### ##### ### ######### # # # ####### # # # # # ##### ########### ### ##### # #
#   # #           #       #     # #     #     # # #           # # # # #     # #           #       # # #
# ### ############# ##### ##### # # # # ### # # # ##### ##### # ### ### ### # # ########### ####### # #
#     #   #       #   #     #   # # # # #   #   # #   # # #   #   # #     # # # #         #       # # #
### ### # # ### ####### ### ### ##### # ##### ##### ### # ### ##### ### # # # ##### ####### ##### # # #
#     # #   #       #     #     #     # #         #   #   #       #   # #   #     #       # #     #   #
# ### ####### ##### ### ### ##### ##### ### ####### ### ######### ### # # ### ##### ####### # ### #####
# #       #   #     #     #   # # #       #       # # #              # #   # #         #   #   #       #
# ####### # ### ######### ### # # ##### ### ### ### # # ### ######### ##### ### ####### # ### #########
#       # # #         #   #   # #   #     #   #     #   #   #       #       #   #       # # #   #     #
####### # ### ### ### ### ### # # ### ######### ##### # ##### ##### ######### ### ### ##### ### # #####
#       # #   #   # # # #     #     #         #       #   #     # # #       # # #   #   #     # #     #
# ### ##### ##### ### # # ##### ##### ########### ######### ### # # # ##### # # ### ### # ### # #######
#   # #     #   #     # #     #     #       #   #         # # # #   #     # #   #       # # #         #
# ### ### ### ######### ### ### ##### ##### # # ####### ### # ### ### ##### ##### ######### ####### ###
#     #   # # #   #       # #     #       # #   #     # #   #   #   # #       #       #   #         # #
##### ### # ### # # ##### ### # # ####### ### ######### ### ### # ### ####### ### ####### ####### ### #
#     #   #     #   #   #     # #   #     #   #         # #   # #   #   #     #       #       #     # #
# ### ##### ### ##### # ##### ### ##### ### ### ####### # ### ##### ### # ### ##### ### ##### ##### # #
#   #     # #       # # #     # #     # # # # #       # #   #     #   # #   # #     #   #   # #     # #
# ### ### ### ####### ### ##### ### ### ### # ##### ### ####### ##### ### # # # ### ##### ### # ##### #
# #     #   #       #     #       # #   # #     # #     #   # #     #   # # #   #     # #   #   # #   #
# ### ##### ####### ##### ######### ### ### ####### ##### ### # ### ##### ### ### ##### ### ### ### ###
#   # #       #   # #     #     #   #       #           # #     # #     #   # #   # #   #       #     #
# ### # ####### # # ##### ### # # # # ######### ######### ####### ####### ### # ### # # # ####### ### #
#     # #       #   #     #   # # # # #       #             #       #     #     #   # #         #   # #
##### # # ####### ### ##### ##### ### ### ### ########### ### ### ### ####### ####### ####### ####### #
#     #     #       #         # # # #     # #     #   #     #     #     #       #   #     #   #       #
# ############### ########### # # # # ##### ##### # ### ### ##### ####### ##### ### ##### ### ### ##### 
#   #             #   #       # # # # #     #     #   # #     #   #         #   #   #   #   #     #    #
### # ########### ### # ##### # # ### # ####### ##### # ##### ##### ######### ##### # # ##### ###### ###
#   # #       #   #     #   #   #     #   #     #       #       #   #       #       # #     #         # #
# ### ### ### ### ### ####### ### ##### ### ####### ### ######### ##### ####### ##### ######### ####### #
# #     #   #   #   #     #     #       #   #     #   #         #       #       # #         #   #       #
# ### # ##### ##### ####### ####### ######### ##### ### ######### ####### ####### ####### ### ######### #
#   # #   #     #       #       # #         #   #   # #         # #         #   #       #   #           #
### ### ### ### ##### ##### ##### ### ########### ### ####### ### # ######### ### ### ####### ####### ###
#     #     #   #     #       #       #   #         # #         #   #   #         #       #     #       #
##### ####### ##### ### ####### ######### ### ####### ### ####### ##### ##### ####### ##### ##### #######
#         #   #   #     #   # #   #   #       #       #       # #       #   #       #       #           #
# ##### ### ##### ### ### # ### # # ####### ##### ### ####### # ####### ### ### ####### ##### ### #######
# #     #       # #   #   #     # #       #   #   # # #       #   #   #       #       #     #       #   #
# # ######### ### # # ### ### ### ##### ### ### ### # ####### ### ### # ########### ### ### ### ##### ###
#       #       # #     #   # # #     # #       #   #   #   #     # # #       #   #   #     #   #       #
### ##### ######### ### ##### ### ### # ######### ####### ### ##### # ####### # ### ##### ##### ### #####
#   #   # #     #     #       #     #   #         #       #     #     #   #   #     #     #   #       # #
# ### # # ### ##### ####### ### ##### ### ##### ### ########### ####### ### ####### ### ### ### ####### #
#     # #   #     # #       # #     #   #   #   #   #           #     #   # #       #   #   #           #
##### ### # ##### ### ####### ##### # ##### ### ### ##### ####### ##### ### # ####### ### ### ####### ###
#         # #   #     #       #   # #     #     # #   #       #       #   #       #     #     #         #
##### ### # ### ####### ####### # # ### ### ####### ####### ##### ##### ### ### ######### ##### #########
#     #   #   # #   #       #   # #     #     #     #       #     #     #       #       # #   #       # #
# ### ######### ### # ##### ##### ####### ### # ########### ##### ### ######### ### ##### ### ##### ### #
# #     #   #     # #       #     #       #   # #           #         #         #           #   #   #   #
# # ### # # ##### # ####### ##### ### ####### ### ########### ######### ######### ########### ### # # # #
# # #   # # #   # # #       #     #   #     #   #   #     # #   #   #   #     # #       #     #     # # #
# # ##### ### # # # # ##### ### ### ### ### ####### # ### # ### ### ### ### ### ####### # ##### ##### # #
# #       #   #   # # #   # #   # #       #   #       #   #     #   # #   #   #   #     #     #   #   # #
# ### ####### ##### ### ### ### ##### ### ### # ##### ### ####### ### ### ####### ### ####### ##### ### #
#   #         #       #     # #     #   #     # #     #       #       #   #         #         #     #   #
# ####### ##### ##### ####### ####### ### ##### ### ### ####### ######### ########### ### ##### ### ### #
# #       #     # #       # #   #   #   #   #     #   #   #   #   #       #       #   #   #   #   # #   #
# ##### ### ### ### ##### # ### # ### ##### ##### ### ### ### ### ### ##### ##### ##### ##### ### ### # #
#       #   # #   #     # #     #   #     #       #   #   # #     # #     #       #         #       # # #
##### ##### ##### ##### # ### ### # ### ##### ##### ### # # # ##### ##### ######### ######### ##### ### #
#       #     #   #     #   #   # #     # #     #       # # #     #   #     #   #       #     #         #
### ### ####### ### ### ####### # ####### # ### ##### ##### ####### ### ### # # ##### ##### ### ##### ###
#   # # #       #     #       #     #       #       #   # #   #   #     # # #   #     #         #       #
### ### ##### ########### ##### ########### ####### ### # ### # ### ##### ### ### ##### ####### ### ### #
#   #       # #         #     # #       # # #       #   #   # #       #     # #       # #         #     #
# ####### ### # ##### ### ##### # ##### ### ##### ##### ### ##### ### ### ### ### ### ####### ### ### ###
#     #   #     #   #     #     #     #     #   # #     # #     # #     # #       #     #       #   #   #
### ### ######### ### ### ### ####### ### ##### # ##### # ##### ### ##### ####### ### ### ####### ### ###
#   # #           #     #   #   #     #       #   #     #   #       #       #   #     #   #   # #     # #
### ### ########### ### ##### ### ### ### ######### ### ### ### ##### ######### ####### ### # # ####### #
#     # #     #   #   #       #   #   #         # #   #     #     #   #     #           # # # # #     # #
# ##### # ##### ##### ##### ### ### ########### # ####### ##### ##### ##### ### ######### # # ### ### # #
# #   # #       #       #   #     # #       #   #       # #   # #       #       #   #     # # #     #   #
# # # # ####### ##### # ### ### ##### ### # ### ####### ### ### ####### ### ##### ##### ##### ####### ###
# # # #       # #   # # #   #       # # # #     #   #       #       # # #       #     #   #   #     #   #
# # # ####### ### ### ### ### ##### # # # ####### ##### ##### ####### ### ### ####### ### ### ##### ### #
#   #       #     #       #       # # #   #     #     # # #   #         #   # #       #   #         #   #
##### ##### ### ##### ##### ##### # # ##### ### ##### # # ### # ########### ##### ##### ### ######### ###
#   #     #     #     #     #     # #       # #       #     #   #         #     # #       #           # #
### # ########### ######### ### ### ####### ### ### ### ##### ### ####### ### ### # ##### ### ######### #
# # # #         #       #     # #     #   # #     #   #       #     #       #   #       #     #       # #
# # # ### ### ##### ### # ##### ####### # # ### ##### ### ####### ### ####### ########### ##### ####### #
# #     # #     # #   # #       #       # #     #     #       #     # #         #   #   #   #       #   #
# ### ### ##### # ##### ##### ### ### ######### ##### ######### ### # # ######### ### # ### ######### ###
# #   #   #     #   #   #     # # #   #         # #   #       # #   # #     #         # # # #   #     # #
# # ### ### ### ##### ### ### # ### ### ####### # # ##### ### # # ##### ##### ######### ### ### ##### ###
# # #   #   #   #     # # # #   #       #     # #   #     # #   #     #     #       #         #     #   #
# # # ##### ##### ####### # ### # ### ####### ######### ### ##### ### ####### ##### # ##### ####### ### #
# # #     #     #         #     #   #       #       #   #   #   #   #       # #     # #     #     #     #
# # ####### ### ########### ##### # ##### ##### ##### ##### # # # ####### ##### ##### ### ##### ####### #
# # #       #   #         #   #   #       # #   # # #     # # # # #       #     #     #   # # #       # #
# # ##### ### # ##### ##### ### ########### ### ### ### # # # ### ##### ##### # ##### # ### # ######### #
#   #     # # # #     #     #   #   #         #     #   # # #     #         # #     # #       #         #
### ####### ### ### ### ##### ### # # ### ####### ### ##### ##### ### ########### ##### ### ### ####### #
#   #     # #     #     #   #   #   #   #   #   #   # #         # # #   #   #     #       #   #   #     #
# # # ##### ### ### ### ##### ### ##### ### # # ##### ########### ### ##### # ##### ######### ##### ### #
# # #       # #   # #       #     #   # #   # # #     #         #       # # # #         # #       # # # #
# # ##### ### ### # ### ##### ### # ### ### ### # ### ######### ##### ### # # # ### ####### ### ### # # #
# #     # #     # #   # #   #   # #   #     #   # #   #       #     # #   #   #     #       #     #   # #
# ##### # ### ### ##### ### ##### ####### ####### ### # ##### ##### ### ### ##### ##### ##### ##### #####
#     # #     #       #     #   #   #           #   #       #   #       #       #   # #         #       #
##### ### ### ####### ##### ##### ### ######### ### ### ####### # ########### ##### # ##### ##### #######
# #     # #   #   #   #       #       #       #       # #         #   #       #   # #   #       #     # #
# # ##### ### # ### ####### ### ####### ### ########### # ##### ##### # ####### ### ### ####### ### # # #
# #   #     # #     #     #   #   # #     #     #     # # #   # #     #     # # # #     # #       # # # #
# ### # ### # ### ### # ### ### ### # # ######### ### # # ### # # ######### # ### ##### # ##### # ### ###
# #   # #   # # #     #   # # #     # # #     #     # #     #   #           #   #   #   #     #   #   # #
# # ### ### ### # ##### ### # ### ####### ##### ##### ####### ### ########### ####### ####### ### ### # #
#     #       # #     #   # #     #   #         #     # #         #     #       #     #     # #     #   #
# ### ####### ### ### ##### ##### # # ####### ##### ### ### ####### ##### ### ##### ####### ##### #######
#   #   # #       #   #   #   #   # #       #     #   #       #       #   #     #   #   #       #   #   #
# # ### # # ##### ### ##### # ##### ### ####### # # ##### ### ### ### ### # ### ### ##### ##### ##### ###
# # #     #   #       #     #   #   #   #       # # #     #     #   # #   # #   #   #       #       #   #
# ### ### ### ##### ####### ##### ### ##### ##### ### ### ### ##### ### ### ### ##### ######### ##### ###
#     # #     #     #     # #       #   #   #   #     #   #     #     #       #         #       #     # #
### ### ##### # ### ### ### # ##### ### ### ### ### ### ##### ### ######### ####### ######### ######### #
#   # #       #   #   #   #   #       #   # # #   # # #       #     #       #   #     #         #       #
# ### ##### ##### ### ### ##### ### ### ##### ##### # ### ######### ### ##### # ##### ####### ### #######
#   # #   #       # #   #     #     # #     #     #     # #     #   #   #   # #       #       # #       #
# ##### ##### ##### # ### ##### ### # ### ##### ####### # # ### ### ### # ### ##### ####### # ### #######
#       #       #   #   #     # #   # #       #       #         # #     # #   # #   #   #   # #       # #
# ######### ### ### ### ##### ### ##### ##### ######### ##### ### ####### ##### ##### ### ### # ##### ###
#           #       #   # #   #       #   # #       #       #   #         #       #       #   #     # # #
########### ####### ### # # # ### ### ### # ### ### # ####### ######### ### ##### ##### ######### ### # #
#         # #       #   # # # #   #   #   #     # # # #     #         #   #     #         #       # #   #
# ####### ### ### ####### # # ### ### # ### ##### # # ##### ##### ### ##### ########### ##### ### #######
#   #         # #       # # #     #   # #       #   #     #     #   # #   #   #     #       #   #       #
### ##### ##### # ##### ### # ### # ### ### ########### ##### ##### ### ##### # ### # ##### ### ### ### #
#     #     # # #     # #   #   # #     #         #       #     #       #     # #   #     # #   #     # #
# ####### ### # ##### ### ### ##### ########### ##### ##### ### ### ##### ### # ####### # # ##### ##### #
#       #     #     #     # #         #         #     #     # #     #     #   #     #   # #       #   # #
# ##### ### ##### ##### ### ### ##### ### ##### ### ### ### # ##### ### ### ####### ### ### ### ##### ###
#     # # #     # #       #     #     #   # #     # # #   #   # #       #   #     #       # #     #   # #
# # ##### # ##### ##### ### ########### # ### ### # ### ### # # ##### ### ### ### ########### ##### ### #
# # #       #       # #     #         # #     # # # #       # #       #     #     #       #         #   #
# # ####### ####### # ##### ### ##### ##### ### # ### ####### ### ##### ### ### ##### ##### ### ##### ###
# # #       #   #   # #     # #     # #       # #     #     #     #     # # # #     #     #   #     #   #
# # # ######### ### # ####### ##### # ##### ### ### ##### ### ##### ##### # # ##### ### ##### ### ##### #
# # #     #   # # # # #   #     #   #     #     #   #   #     #   #   #   #           #       #   #   # #
# ### ### ### ### # ### ##### ### ### ####### ##### # ##### ### # # # # ### ####### ### ##### ##### ### #
#     #     #     #       #       #   #   #     #     #   #     # #   #   # #         # #   #       # # #
### ### ######### ####### ####### ### # ### ### ### ##### # ##### ##### # ### ######### ### ### ##### # #
#   #         #   #         #     #   #     # #     #   # #       #     #   #       #     #   #   #   # #
# ##### ##### # ######### # ##### ### # ### # # ##### ### ### ##### ##### ### ##### # ### # # ### ### # #
#       #   #   #       # #     #     # #   #   #     #     #   #     #   #   #     #   # # # #   #   # #
# ##### ##### ### ####### ##### ### ### ### ### ##### ##### ### ### ##### # ### ### ### # ##### ### ### #
# #         #   #       #     #   # #     #       #     #     #   # #   # #     #       #         #     #
# ##### ### ##### ####### ### ##### ##### ##### # # ##### ### ### ### # ### ### # ##### # ### ###########
#     #   #       #         #           #       #       #         #       #   #       #   #             B
#########################################################################################################
